1.305033528336100101e+09 1.502399999999999958e+00 -1.197699999999999987e+00 6.491000000000000103e-01 -9.072969015863715514e-01 -4.079986066871363337e-02 3.429988286609997328e-02 4.170985756107965514e-01
1.305033528366100073e+09 1.502372437034100727e+00 -1.191613111596450558e+00 6.479515097537875690e-01 -9.073038601792148272e-01 -4.118502926272329945e-02 3.391998320657384908e-02 4.170766517173914445e-01
1.305033528406100035e+09 1.504129261529899786e+00 -1.182657891819071994e+00 6.444518517090909171e-01 -9.062138367197901667e-01 -4.124924779959897314e-02 3.421393461020284799e-02 4.194095711497935475e-01
1.305033528436199903e+09 1.506189515829519099e+00 -1.175270472308614034e+00 6.447702621319836291e-01 -9.059514803316268683e-01 -4.083568600794942882e-02 3.465825936850104594e-02 4.199799603442284091e-01
1.305033528466099977e+09 1.505222357896574881e+00 -1.167432425592540790e+00 6.437074219702499933e-01 -9.052448969936673917e-01 -4.270470187133369039e-02 3.331937823245535724e-02 4.214235445952297932e-01
1.305033528506200075e+09 1.504297629158647398e+00 -1.156177505774396597e+00 6.396711295318362467e-01 -9.044954260923264711e-01 -4.251315553752735982e-02 3.351602062058531978e-02 4.230334882087510295e-01
1.305033528536099911e+09 1.506877921099248896e+00 -1.146880593240936497e+00 6.391058766269688274e-01 -9.040008539652381048e-01 -4.450131233099618999e-02 3.612694697674743993e-02 4.236707836670811633e-01
1.305033528566099882e+09 1.509378112245127745e+00 -1.137211652778051363e+00 6.366562573587453144e-01 -9.029902955944106857e-01 -4.680775084710794842e-02 3.862825873667788401e-02 4.253532862808585557e-01
1.305033528606100082e+09 1.508557763596106938e+00 -1.123331664820752529e+00 6.329021979027317224e-01 -9.014822057707777558e-01 -4.980883259245899586e-02 3.885396272331503864e-02 4.281813663100309530e-01
1.305033528636100054e+09 1.506678892828711147e+00 -1.113756170614283780e+00 6.276486509731502572e-01 -8.996002308156629823e-01 -5.302033985519903625e-02 3.908282383146587102e-02 4.317184280979948774e-01
1.305033528666100025e+09 1.506678892828711147e+00 -1.113756170614283780e+00 6.276486509731502572e-01 -8.996002308156629823e-01 -5.302033985519903625e-02 3.908282383146587102e-02 4.317184280979948774e-01
1.305033528706099987e+09 1.504635786742841486e+00 -1.116984159012328170e+00 6.122192696367526610e-01 -8.885093770629151066e-01 -5.264197389934283794e-02 3.645082134921445033e-02 4.543690648341048299e-01
1.305033528736099958e+09 1.495454912178143969e+00 -1.113769912299998888e+00 6.048138553809820905e-01 -8.852261397007066268e-01 -4.519047836666123530e-02 3.068502014843981635e-02 4.619425633063783954e-01
1.305033528766099930e+09 1.497327831613437965e+00 -1.101998622839694519e+00 6.035573056483319876e-01 -8.850579481398408443e-01 -4.551162469480676820e-02 3.107210253031115338e-02 4.622073613611967779e-01
1.305033528806099892e+09 1.505060139958020571e+00 -1.089805415647262077e+00 6.105399345248161413e-01 -8.857676598057925288e-01 -4.590082844621216906e-02 3.167190126685172358e-02 4.607663805664038992e-01
1.305033528836100101e+09 1.504188134308139135e+00 -1.078140599752637208e+00 6.149253280409195943e-01 -8.871190555181229787e-01 -4.446544565577190133e-02 2.928552519056851905e-02 4.584593367939837072e-01
1.305033528866100073e+09 1.505313212470506201e+00 -1.067096810261696005e+00 6.093531729095236216e-01 -8.861610485100233081e-01 -4.103841606578251255e-02 3.002540267291429338e-02 4.605788962867897185e-01
1.305033528906100035e+09 1.507941748227060064e+00 -1.050675730383552331e+00 6.083096522283006902e-01 -8.858158851562455416e-01 -3.915966769262746450e-02 3.112477635009725657e-02 4.613328368198133522e-01
1.305033528936100006e+09 1.511530959692400922e+00 -1.038552351627981540e+00 6.083449878483984108e-01 -8.849385524639720169e-01 -3.859762431383365749e-02 3.136300767021185654e-02 4.630446452667130175e-01
1.305033528966000080e+09 1.514661588429420780e+00 -1.026798153347452836e+00 6.060650785315709888e-01 -8.842016957814580191e-01 -3.788396029839388723e-02 2.981223066500298183e-02 4.646110175534802211e-01
1.305033529006099939e+09 1.513392388715600223e+00 -1.010780734375755774e+00 6.010920088988832566e-01 -8.828632991785133610e-01 -3.635892593667702094e-02 2.556650884876649626e-02 4.675219535953880068e-01
1.305033529036099911e+09 1.513399691000185898e+00 -1.002353012051082404e+00 5.917077964601731299e-01 -8.803026321240827734e-01 -3.562649847925668245e-02 2.396694086584649774e-02 4.724654635283433990e-01
1.305033529066099882e+09 1.512980944228956792e+00 -9.900806783627188468e-01 5.920606094177587320e-01 -8.794875936890254042e-01 -3.872557988219234304e-02 2.106043683312703446e-02 4.738758909358796734e-01
1.305033529106100082e+09 1.520023048974672664e+00 -9.761037250005339949e-01 5.974849559647330555e-01 -8.787019041418346887e-01 -4.031271804078515042e-02 2.355487970772995529e-02 4.750821150744708454e-01
1.305033529136100054e+09 1.520499470590669810e+00 -9.639781598935914797e-01 6.025528641408062214e-01 -8.786496943156524297e-01 -4.345136821131004301e-02 2.197140641355201096e-02 4.749778421987562171e-01
1.305033529166100025e+09 1.523295649893621873e+00 -9.514740560427051852e-01 6.028335208563790903e-01 -8.768358295028155780e-01 -4.335045929414634708e-02 2.300999253410208889e-02 4.782783771222324232e-01
1.305033529206099987e+09 1.526194280145780624e+00 -9.347521100686317919e-01 6.074416078240307826e-01 -8.769052290325174415e-01 -4.232542083615718764e-02 2.349534585133158590e-02 4.782193500578964529e-01
1.305033529236099958e+09 1.528396053834765178e+00 -9.214603857190657443e-01 6.084071420997804180e-01 -8.750950966065429437e-01 -4.159932969546659143e-02 2.226840966228463975e-02 4.816452902242333023e-01
1.305033529266099930e+09 1.530794530847801926e+00 -9.080406960231175439e-01 6.073397918843431720e-01 -8.727781766656401707e-01 -3.969973246373419140e-02 2.259807651689309249e-02 4.859748064624804242e-01
1.305033529306200027e+09 1.527745094061069286e+00 -8.903312460755787860e-01 6.114466541707295200e-01 -8.721484759237457807e-01 -4.126896889809844593e-02 1.938944762650643763e-02 4.871118531412617081e-01
